{
	"1":{
		"maze": [
			"..................................................",
			"..................................................",
			"..................................................",
			"..................................................",
			"..................................................",
			"..................................................",
			"..................................................",
			"...........s..........e...........................",
			"...........xxxx....xxxx...........................",
			"..............bbb.................................",
			"..................................................",
			"..................................................",
			"..................................................",
			"..................................................",
			"..................................................",
			"..................................................",
			"..................................................",
			".................................................."
		],
		"start": [6,11],
		"end": [6,22],
		"box": [8,14],
		"boxSize": [1,3]
	}
}