{
	"1": {
		"maze": [
			"..................................................",
			"..................................................",
			"..................................................",
			"..................................................",
			"..................................................",
			"..................................................",
			"..................................................",
			"...........s..........e...........................",
			"...........xxxx....xxxx...........................",
			"..............bbb.................................",
			"..................................................",
			"..................................................",
			"..................................................",
			"..................................................",
			"..................................................",
			"..................................................",
			"..................................................",
			".................................................."
		],
		"start": [11, 7],
		"end": [22, 7],
		"box": [14, 9],
		"boxSize": [3, 1]
	},
	"2": {
		"maze": [
			"..................................................",
			"..................................................",
			"..................................................",
			"..................................................",
			"..................................................",
			"...........xs...........x.........................",
			"...........xxxxbb.xxxx..x.........................",
			"........................x.........................",
			"........................x.........................",
			"...........xe...........x.........................",
			"...........xxxx...xxxxxxx.........................",
			"..................................................",
			"..................................................",
			"..................................................",
			"..................................................",
			"..................................................",
			"..................................................",
			".................................................."
		],
		"start": [12, 5],
		"end": [12, 9],
		"box": [15, 6],
		"boxSize": [2, 1]
	}
}