{
	"1": {
		"maze": [
			"..................................................",
			"..................................................",
			"..................................................",
			"..................................................",
			"..................................................",
			"..................................................",
			"..................................................",
			"...........s..........e...........................",
			"...........xxxx....xxxx...........................",
			"..............bbb.................................",
			"..................................................",
			"..................................................",
			"..................................................",
			"..................................................",
			"..................................................",
			"..................................................",
			"..................................................",
			".................................................."
		],
		"start": [11, 7],
		"end": [22, 7],
		"box": [14, 9],
		"boxSize": [3, 1]
	}
}